NO   fldkjagngfjk.xpm










WE   dsodfssddsfdsd.xpm








EA  FHKSHF.xpm











SO  asddasd.xpm










F 255,2,250       








C 1,1,1 







111111111111111111111
10000000000001
100000N01111001                            
11111111    111111111111
111111111111111111111111
101101010101010101001
11111111111111111111            
11111111111111111111              