NO fldkjagngfjk.xpm
WE dsodfssddsfdsd.xpm
EA FHKSHF.xpm
SO FHKSHF.xpm
F 0,2,250
C 1,1,0



1111111111111111111
1111010000000111101
1111010000000011111
1111E00000000000001
1111111111111111111




























