NO fldkjagngfjk.xpm
WE dsodfssddsfdsd.xpm
EA FHKSHF.xpm
SO FHKSHF.xpm
F 0,2,250
C 1,1,0




111111111111111111111
111100000000000000011
10000000N000000111011
111111111111111111111    





























