NO   fldkjagngfjk.xpm
WE   dsodfssddsfdsd.xpm
EA  FHKSHF.xpm
SO  asddasd.xpm
F 255,2,250       
C 1,1,1

1111111111111111
1111111111111111
1000000000S00001
1000000000000000000001
1111111111111111
