NO fldkjag
WE dsodfs
EA FHKSHF
SO SD;LFAS
F 1,1,255
C 1,1,1

111111111111111111111111
10000E000000001
100000000000001
111111111111111111111111
10110101010101010101
11111111111111111111

klhighjfydtu
