NO     fldkjag ngfjk

WE  dsodfssddsfdsd
EA FHKSHF
SO                asddasd 

     FF 255,255,255
C 1,1,1

1111111111111111111111
10000E00000001
100000000000001
111111111111111111111111
10110101010101010101
11111111111111111111
