NO    eqweeqw
WE  dgfdgsakfj
EA ./423624782346
SO ./23423084023



1111111111111
10 00000000001
1111111111111