C        255,      255,  255

111111111111
100000010001
1000000DN001
100000010001
100000010001