NO fldkjag
WE dsodfs
EA FHKSHF
SO SD;LFAS

F 1,1,255
C 1,1,1

111111111111111111101111
100000000000001
100000000000001
111111111111111011111110
10110101010101010101
1111100000011111111111