NO fldkjagngfjk.xpm
WE dsodfssddsfdsd.xpm
EA FHKSHF.xpm
SO FHKSHF.xpm
F 0,2,250
C 1,1,0



1111111111111111111111111
1000000000110000000000001
1011000001110000000000001
1001000000000000000000001
1111111110110000011100001
1000000000110000011101111
1111011111111101110000001
1111011111111101110101001
1100000011010101110000001
100000000N000000110000001
1000000000000000110101001
1100000111010101111101111
11110111 1110101 10111101
11111111 1111111 11111111




























