NO ./textures/walls1.xpm42
WE ./textures/walls2.xpm42
EA ./textures/walls3.xpm42
SO ./textures/walls4.xpm42
D ./textures/door.xpm42

F 52,105,56
C 157,204,242

11111111111
10000100001
10000D00001
10E00D00001
10000D00001
10000100001
11111111111
       