NO ./textures/walls1.xpm42
WE ./textures/walls2.xpm42
EA ./textures/walls3.xpm42
SO ./textures/walls4.xpm42
D ./textures/door.xpm42

F 52,105,56
C 157,204,242

1111111
10E0D01
1000D01 
1000101
1111111
