NO ./textures/walls1.xpm42
WE ./textures/walls2.xpm42
EA ./textures/walls3.xpm42
SO ./textures/walls4.xpm42
D ./textures/door.xpm42

F 52,105,56
C 157,204,242


11111111111111111111
11110100001001111111
11110100110000111101
1111E0000000D0000011
11111111111111111111
