NO ./textures/walls1.xpm42
WE ./textures/walls2.xpm42
EA ./textures/walls3.xpm42
SO ./textures/walls4.xpm42
D ./textures/door.xpm42
F 52,105,56
C 157,204,242


11111111111111111111
1N00000000000000000D1
100001111111110000001
1D0001000000010000001
111001101110001001111
100000100010001000001
100000100010001000001
1D00001111000100000D1
100000000000001000001
111111011111111011111
100000010000000000001
1D0000100011111110001
100000010000001000001
111111111000001011111
100000000000001000001
100000111111111000001
1D0001000000000010001
100000100000000001001
1D00000000000000000D1
11111111111111111111