NO ./textures/walls1.xpm42
WE ./textures/walls2.xpm42
EA ./textures/walls3.xpm42
SO ./textures/walls4.xpm42
D ./textures/door.xpm42

F 52,105,56
C 157,204,242

1111111
10ED001
10D0001 
1111111
