NO ./textures/walls1.xpm42
WE ./textures/walls2.xpm42
EA ./textures/walls3.xpm42
SO ./textures/walls4.xpm42

F 52,105,56
C 157,204,242


1111111111111111111
1111010D00000111101
1111010000000011111
1111E0000000D000001
1111111111111111111
