NO ./textures/north.xpm42
WE ./textures/west.xpm42
EA ./textures/east.xpm42
SO ./textures/south.xpm42
F 0,0,255
C 255,0,0


1111111111111111111
1111010000000111101
1111010000000011111
1111E00000000000001
1111111111111111111





