NO ./textures/walls1.xpm42
WE ./textures/walls2.xpm42
EA ./textures/walls3.xpm42
SO ./textures/walls4.xpm42
F 52,105,56
C 157,204,242


11111111111
10000001001
10000N00101
10000000001
11111111111