NO ./textures/walls1.xpm42
WE ./textures/walls2.xpm42
EA ./textures/walls3.xpm42
SO ./textures/walls4.xpm42
D ./textures/door.xpm42
F 52,105,56
C 157,204,242


1111111111111111111
1111010000D00111101
1111010000D00011111
1111E00000D00000001
1111111111111111101
                111
               1111
