NO ./textures/walls1.xpm42
WE ./textures/walls2.xpm42
EA ./textures/walls3.xpm42
SO ./textures/walls4.xpm42
F 52,105,56
C 157,204,242


111111111111111
100000001000001
100000000100001
100000N00000001
100000000000001
111111111111111