NO ./textures/walls1.xpm42
WE ./textures/walls2.xpm42
EA ./textures/walls3.xpm42
SO ./textures/walls4.xpm42
F 52,105,56
C 157,204,242


1111111111111111111
1111000000000000111
1111000000000000111
1111N00000000000111
1111111111111111111
